##########
#....s...#
#........#
#@.......#
##########